[
  {
    "index": 10,
    "rooms": [
      71, 61, "93a", 70, 69, 62, 68, 67, 65, 55,
      66, 43, 81, 41, 42, 44, 82, 39, 37, 38,
      40, 35, 33, 34, 36, 7, 75, 8, 31, 29, 30, 32,
      27, 25, 26, 28, 21, 22, 79, 88, 89, 90,
      80, 20
    ]
  },

  {
    "index": 9,
    "rooms": [
      91, 45, 83, 46, 60, "92a", 63, "93a",
      65, 72, 67, 66, 43, 51, 52, 17, 50,
      18, 44, 39, 11, 12, 40, 35, 9, 10, 36,
      78, 7, 95, 97, 98, 96, 94, 8, 74, 31,
      32, 5, 6, 27, 3, 4, 28, 86, 21, 1, 2,
      22, 79, 90, 20
    ]
  },

  {
    "index": 8,
    "rooms": [
      85, 91, 84, 45, 56, 46, 60, "92b",
      63, "93b", 100, 72, 65, 43, 51, 53, 17,
      54, 50, 18, 44, 39, 11, 13, 15, 12, 14,
      16, 40, 35, 9, 10, 36, 78, 77, 107, 109,
      101, 103, 102, 105, 108, 110, 104, 76,
      74, 106, 31, 32, 5, 6, 27, 3, 4, 28, 86,
      21, 1, 2, 22, 79, 90, 20
    ]
  },

  {
    "index": 7,
    "rooms": [
      205, 207, 215, 217, 225, 229, 253, 233,
      243, 245, 249, 247, 58, 223, 251, 209,
      213, 219, 231, 235, 239, 241, 211, 203,
      204, 221, 208, 214, 216, 212, 210, 218,
      220, "201a", 222, 237, 244, 242, 230,
      226, 228, 246, 240, 232, 238, 234, 248,
      236, 200, 255, 257, 254, 256, 258, 259,
      261, 260, 87, 263, 262, 265, 267, 269, 268, 270
    ]
  },

  {
    "index": 6,
    "rooms": [
      300, 303, 307, 309, 311, 313, 315,
      321, 317, 325, 305, 301, "201b",
      306, 308, 310, 312, 316, 314, 318,
      320, 322, 324, 328, 326, 334, 330,
      331, 333, 329, 327, 350, 351, 352,
      353, 255, 257, 254, 256, 354, 357,
      355, 259, 355, 360, 804
    ]
  },

  {
    "index": 5,
    "rooms": [
      403, 400, 407, 409, 415, 417, 402, 401,
      405, 411, 413, 419, 425, 421, 420, 422,
      424, 426, 428, 418, 416, 414, 412, 410,
      408, 406, 404, "201c"
    ]
  },

  {
    "index": 4,
    "rooms": [
      500, 503, 509, 511, 501, 502, 505, 507,
      513, 515, 517, 521, "201d", 519, 518, 520,
      516, 514, 512, 510, 506, 508, 504
    ]
  },

  {
    "index": 3,
    "rooms": [
      600, 607, 621, 605, 609, 617, 613, 603,
      611, 615, 601, "201e", 602, 604, 608, 606, 610,
      614, 612, 618, 616, 620, 619, 615
    ]
  },

  {
    "index": 2,
    "rooms": [
      700, 701, 703, 704, "201f", 702
    ]
  },

  {
    "index": 1,
    "rooms": [
      800, 801, 132
    ]
  }
]